XXXXXXXXXXXXXXXXXXXXXXXXXXXXXX
XXXXXXXXXXXXXXXXXXXXXXXXXXXXXX
XXXXXXXXXXXXXXXXXXXXXXXXXXXXXX
XXXXXXXXXXXXXXXXXXXXXXXXXXXXXX
XXXXXXXXXXXXXXXXXXXXXXXXXXXXXX
XXXXXXXXXXXXXXXXXXXXXXXXXXXXXX
XXXXXXXXXXXXXXXXXXXXXXXXXXXXXX
XXXXXXXXXXXXXXXXXXXXXXXXXXXXXX
XXXXXXXXXXXXXXXXXXXXXXXXXXXXXX
XXXXXXXXXXXXXXXXXXXXXXXXXXXXXX
XXXXXXXXXXXXXXXXXXXXXXXXXXXXXX
XXXXXXXXXXXXXXXXXXXXXXXXXXXXXX
XXXXXXXXXXXXXXXXXXXXXXXXXXXXXX
XXXXXXXXXXXXXXXXXXXXXXXXXXXXXX
XXXXXXXXXXXXXXXXXXXXXXXXXXXXXX
XXXXXXXXXXXXXXXXXXXXXXXXXXXXXX
XXXXXXXXXXXXXXXXXXXXXXXXXXXXXX
XXXXXXXXXXXXXXXXXXXXXXXXXXXXXX
XXXXXXXXXXXXXXXXXXXXXXXXXXXXXX
XXXXXXXXXXXXXXXXXXXXXXXXXXXXXX
XXXXXXXXXXXXXXXXXXXXXXXXXXXXXX
XXXXXXXXXXXXXXXXXXXXXXXXXXXXXX
XXXXXXXXXXXXXXXXXXXXXXXXXXXXXX
XXXXXXXXXXXXXXXXXXXXXXXXXXXXXX
XXXXXXXXXXXXXXXXXXXXXXXXXXXXXX
XXXXXXXXXXXXXXXXXXXXXXXXXXXXXX
XXXXXXXXXXXXXXXXXXXXXXXXXXXXXX
XXXXXXXXXXXXXXXXXXXXXXXXXXXXXX
XXXXXXXXXXXXXXXXXXXXXXXXXXXXXX
XXXXXXXXXXXXXXXXXXXXXXXXXXXXXX
XXXXXXXXXXXXXXXXXXXXXXXXXXXXXX
XXXXXOOOOOOOOOOOOOOOOOOOOOOOOX
XXXXXOOOOOOOOOOOOOOOOOOOOOOOOX
XXXXXOOOOOOOOOOOOOOXXXXXOOOOOX
XXXXXOOOOOOOOOOOOOOXXXXXOOOOOX
XXXXXOOOOOOOOOOOOOOXXXXXOOOOOX
XXXXXOOOOOOOOOOOOOOOOOOOOOOOOX
XXXXXOOOOOOOOOOOOOOOOOOOOOOOOX
XXXXXOOOOOOOOOOOOOOOOOOOOOOOOX
XXXXXOOOOOOOOOOOOOOOOOOOOOOOOX
XXXXXOOOOOOOOOOOOOOOOOOOOOOOOX
XXXXXOOOOOOOOOOOOOOOOOOOOOOOOX
XXXXXOOOOOOOOOOOOOOOOOOOOOOOOX
XXXXXOOOOOOOOOOOOOOOOOOOOOOOOX
XXXXXXOOOOOOOOOOOOOOOOOOOOOOOX
XXXXXXOOOOOOOOOOOOOOOOOOOOOOOX
XXXXXOOOOOOOOOOOOOOOOOOOOOOOOX
XXXXXOOOOOOOOOOOOOOOOOOOOOOOOX
XXXXXOOOOOOOOOOOOOOOOOOOOOOOOX
XXXXXOOOOOOOOOOOOOOOOOOOOOOOOX
XXXXXOOOOOOOOOOOOOOOOOOOOOOOOX
XXXXXOOOOOOOOOOOOOOOOOOOOOOOOX
XXXXXOOOOOOOOOOOOOOOOOOOOOOOOX
XXXXXOOOOOOOOOOOOOOOOOOOOOOOOX
XXXXXOOOOOOOOOOOOOOOOOOOOOOOOX
XXXXXOOOOOOOOOOOOOOOOOOOOOOOOX
XXXXXOOOOOOOOOOOOOOOOOOOOOOOOX
XXXXXOOOOOOOOOOOOOOOOOOOOOOOOX
XXXXXOOOOOOOOOOOOOOOOOOOOOOOOX
XXXXXXXXXXXXXXXXXXXXXXXXXXXXXX
XXXXXXXXXXXXXXXXXXXXXXXXXXXXXX
XOOOOOOOOOOOOOOOOOOOOOOOOOOOOX
XOOOOOOOOOOOOOOOOOOOOOOOOOOOOX
XOOOOOOOOOOOOOOOOOOOOXXXOOOOOX
XOOOOOOOOOOOOOOOOOOOOXXXOOOOOX
XOOOOOOOOOOOOOOOOOOOOXXXOOOOOX
XOOOOOOOOOOOOOOOOOOOOOOOOOOOOX
XOOOOOOOOOOOOOOOOOOOOOOOOOOOOX
XOOOOOOOOOOOOOOOOOOOOOOOOOOOOX
XOOOOOOOOOOOOOOOOOOOOOOOOOOOOX
XOOOOOOOOOOOOOOOOOOOOOOOOOOOOX
XOOOOOOOOOOOOOOOOOOOOOOOOOOOOX
XOOOOOOOOOOOOOOOOOOOOOOOOOOOOX
XOOOOOOOOOOOOOOOOOOOOOOOOOOOOX
XOOOOOXXXXOOOOOOOOOOOOOOOOOOOX
XOOOOOXXXXOOOOOOOOOOOOOOOOOOOX
XOOOOOOOOOOOOOOOOOOOOOOOOOOOOX
XOOOOOOOOOOOOOOOOOOOOOOOOOOOOX
XOOOOOOOOOOOOOOOOOOOOOOOOOOOOX
XOOOOOOOOOOOOOOOOOOOOOOOOOOOOX
XOOOOOOOOOOOOOOOOOOOOOOOOOOOOX
XOOOOOOOOOOOOOOOOOOOOOOOOOOOOX
XOOOOOOOOOOOOOOOOOOOOOOOOOOOOX
XOOOOOOOOOOOOOOOOOOOOOOOOOOOOX
XOOOOOOOOOOOOOOOOOOOOOOOOOOOOX
XOOOOOOOOOOOOOOOOOOOOOOOOOOOOX
XOOOOOOOOOOOOOOOOOOOOOOOOOOOOX
XOOOOOOOOOOOOOOOOOOOOOOOOOOOOX
XOOOOOOOOOOOOOOOOOOOOOOOOOOOOX
XXXXXXXXXXXXXXXXXXXXXXXXXXXXXX
XXXXXXXXXXXXXXXXXXXXXXXXXXXXXX
XOOOOOOOOOOOOOOOOOOOOOOOOOOOOX
XOOOOOOOOOOOOOOOOOOOOOOOOOOOOX
XOOOOOOOOOOOOOOOOOOOOOOOOOOOOX
XOOOOOOOOOOOOOOOOOOOOOOOOOOOOX
XOOOOOOOOOOOOOOOOOOOOOOOOOOOOX
XOOOOOOOOOOOOOOOOOOOOOOOOOOOOX
XOOOOOOOOOOOOOOOOOOOOOOOOOOOOX
XOOOOOOOOOOOOOOOOOOOOOOOOOOOOX
XOOOOOOOOOOOOOOOOOOOOOOOOOOOOX
XOOOOOOOOOOOOOOOOOOOOOOOOOOOOX
XOOOOOOOOOOOOOOOOOOOOOOOOOOOOX
XOOOOOOOOOOOOOOOOOOOOOOOOOOOOX
XOOOOOOOOOOOOOOOOOOOOOOOOOOOOX
XOOOOOOOOXXXOOOOOOOOOOOOOOOOOX
XOOOOOOOOXXXOOOOOOOOOOOOOOOOOX
XOOOOOOOOOOOOOOOOOOOOOOOOOOOOX
XOOOOOOOOOOOOOOOOOOOOOOOOOOOOX
XOOOOOOOOOOOOOOOOOOOOOOOOOOOOX
XOOOOOOOOOOOOOOOOOOOOOOOOOOOOX
XOOOOOOOOOOOOOOOOOOOOOOOOOOOOX
XOOOOOOOOOOOOOOOOOOOOOOOOOOOOX
XOOOOOOOOOOOOOOOOOOOOOOOOOOOOX
XOOOOOOOOOOOOOOOOOOOOOOOOOOOOX
XOOOOOOOOOOOOOOOOOOOOOOOOOOOOX
XOOOOOOOOOOOOOOOOOOOOOOOOOOOOX
XOOOOOOOOOOOOOOOOOOOOOOOOOOOOX
XOOOOOOOOOOOOOOOOOOOOOOOOOOOOX
XOOOOOOOOOOOOOOOOOOOOOOOOOOOOX
XXXXXXXXXXXXXXXXXXXXXXXXXXXXXX
XXXXXXXXXXXXXXXXXXXXXXXXXXXXXX
XOOOOOOOOOOOOOOOOOOOOOOOOOOOOX
XOOOOOOOOOOOOOOOOOOOOOOOOOOOOX
XOOOOOOOOOOOOOOOOOOOOOOOOOOOOX
XOOOOOOOOOOOOOOOOOOOOOOOOOOOOX
XOOOOOOOOOOOOOOOOOOOOOOOOOOOOX
XOOOOOOOOOOOOOOOOOOOOOOOOOOOOX
XOOOOOOOOOOOOOOOOOOOOOOOOOOOOX
XOOOOOOOOOOOOOOOOOOOOOOOOOOOOX
XOOOOOOOOOOOOOOOOOOOOOOOOOOOOX
XOOOOOOOOOOOOOOOOOOOOOOOOOOOOX
XOOOOOOOOOOOOOOOOOOOXXROOOOOOX
XOOOOOOOOOOOOOOOOOOOOOOOOOOOOX
XOOOOOOOOOOOOOOOOOOOOOOOOOOOOX
XOOOOOOOOOOOXXXXOOOOOOOOOOOOOX
XOOOOOOOOOOOXXXXOOOOOOOOOOOOOX
XOOOOOOOOOOOOOOOOOOOOOOOOOOOOX
XOOOOOOOOOOOOOOOOOOOOOOOOOOOOX
XOOOOOOOOOOOOOOOOOOOOOOOOOOOOX
XOOOOOOOOOOOOOOOOOOOOOOOOOOOOX
XOOOOOOOOOOOOOOOOOOOOOOOOOOOOX
XOOOOOOOOOOOOOOOOOOOOOOOOOOOOX
XOOOOOOOOOOOOOOOOOOOOOOOOOOOOX
XOOOOOOOOOOOOOOOOOOOOOOOOOOOOX
XOOOOOOOOOOOOOOOOOOOOOOOOOOOOX
XOOOOOOOOOOOOOOOOOOOOOOOOOOOOX
XOOOOOOOOOOOOOOOOOOOOOOOOOOOOX
XOOOOOOOOOOOOOOOOOOOOOOOOOOOOX
XOOOOOOOOOOOOOOOOOOOOOOOOOOOOX
XXXXXXXXXXXXXXXXXXXXXXXXXXXXXX
XXXXXXXXXXXXXXXXXXXXXXXXXXXXXX
XOOOOOOOOOOOOOOOOOOOOOOOOOOOOX
XOOOOOOOOOOOOOOOOOOOOOOOOOOOOX
XOOOOOOOOOOOOOOOOOOOOOOOOOOOOX
XOOOOOOOOOOOOOOOOOOOOOOOOOOOOX
XOOOOOOOOOOOOOOOOOOOOOOOOOOOOX
XOOOOOOOOOOOOOOOOOOOOOOOOOOOOX
XOOOOOOOOOOOOOOOOOOOOOOOOOOOOX
XOOOOOOOOOOOOOOOOOOOOOOOOOOOOX
XOOOOOOOOOOOOOOOOOOOOOOOOOOOOX
XOOOOOOOOOOOOOOOOOOOOOOOOOOOOX
XOOOOOOOOOOOOOOOOOOOOOOOOOOOOX
XOOOOOOOOOOOOOOOOOOOOOOOOOOOOX
XOOOOOOOOOOOOOOOOOOOOOOOOOOOOX
XOOOOOOOOOOOOOOOOXXXXXOOOOOOOX
XOOOOOOOOOOOOOOOOXXXXXOOOOOOOX
XOOOOOOOOOOOOOOOOOOOOOOOOOOOOX
XOOOOOOOOOOOOOOOOOOOOOOOOOOOOX
XOOOOOOOOOOOOOOOOOOOOOOOOOOOOX
XOOOOOOOOOOOOOOOOOOOOOOOOOOOOX
XOOOOOOOOOOOOOOOOOOOOOOOOOOOOX
XOOOOOOOOOOOOOOOOOOOOOOOOOOOOX
XOOOOOOOOOOOOOOOOOOOOOOOOOOOOX
XOOOOOOOOOOOOOOOOOOOOOOOOOOOOX
XOOOOOOOOOOOOOOOOOOOOOOOOOOOOX
XOOOOOOOOOOOOOOOOOOOOOOOOOOOOX
XOOOOOOOOOOOOOOOOOOOOOOOOOOOOX
XOOOOOOOOOOOOOOOOOOOOOOOOOOOOX
XOOOOOOOOOOOOOOOOOOOOOOOOOOOOX
XXXXXXXXXXXXXXXXXXXXXXXXXXXXXX
XXXXXXXXXXXXXXXXXXXXXXXXXXXXXX
XOOOOOOOOOOOOOOOOOOOOOOOOXXXXX
XOOOOOOOOOOOOOOOOOOOOOOOOXXXXX
XOOOOOOOOOOOOOOOOOOOOOOOOXXXXX
XOOOOOOOOOOOOOOOOOOOOOOOOXXXXX
XOOOOOOOOOOOOOOOOOOOOOOOOXXXXX
XOOOOOOOOOOOOOOOOOOOOOOOOXXXXX
XOOOOOOOOOOOOOOOOOOOOOOOOXXXXX
XOOOOOOOOOOOOOOOOOOOOOOOOXXXXX
XOOOOOOOOOOOOOOOOOOOOOOOOXXXXX
XOOOOOOOOOOOOOOOOOOOOOOOOXXXXX
XOOOOOOOOOOOOOOOOOOOOOOOOXXXXX
XOOOOOOOOOOOOOOOOOOOOOOOOXXXXX
XOOOOOOOOOOOOOOOOOOOOOOOOXXXXX
XOOOOOOOOOOOOOOOOOOOOOOOOXXXXX
XOOOOOOOOOOOOOOOOOOOOOOOOXXXXX
XOOOOOOOOOOOOOOOOOOOOOOOOXXXXX
XOOOOOOOOOOOOOOOOOOOOOOOOXXXXX
XOOOOOOOOOOOOOOOOOOOOOOOOXXXXX
XOOOOOOOOOOOOOOOOOOOOOOOOXXXXX
XOOOOOOOOOOOOOOOOOOOOOOOOXXXXX
XOOOOOOOOOOOOOOOOOOOOOOOOXXXXX
XOOOOOOOOOOOOOOOOOOOOOOOOXXXXX
XOOOOOOOOOOOOOOOOOOOOOOOOXXXXX
XOOOOOOOOOOOOOOOOOOOOOOOOXXXXX
XOOOOOOOOOOOOOOOOOOOOOOOOXXXXX
XOOOOOOOOOOOOOOOOOOOOOOOOXSSXX
XOOOOOOOOOOOOOOOOOOOOOOOOXXXXX
XOOOOOOOOOOOOOOOOOOOOOOOOXXXXX
XXXXXXXXXXXXXXXXXXXXXXXXXXXXXX
XXXXXXXXXXXXXXXXXXXXXXXXXXXXXX
XOOOOOOOOOOOOOOOOOOOOOOOOOOOOX
XOOOOOOOOOOOOOOOOOOOOOOOOOOOOX
XOOOOOOOOOOOOOOOOOOOOOOOOOOOOX
XOOOOOOOOOOOOOOOOOOOOOOOOOOOOX
XOOOOOOOOOOOOOOOOOOOOOOOOOOOOX
XOOOOOOOOOOOOOOOOOOOOOOOOOOOOX
XOOOOOOOOOOOOOOOOOOOOOOOOOOOOX
XOOOOOOOOOOOOOOOOOOOOOOOOOOOOX
XOOOOOOOOOOOOOOOOOOOOOOOOOOOOX
XOOOOOOOOOOOOOOOOOOOOOOOOOOOOX
XOOOOOOOOOOOOOOOOOOOOOOOOOOOOX
XOOOOOOOOOOOOOOOOOOOOOOOOOOOOX
XOOOOOOOOOOOOOOOOOOOOOOOOOOOOX
XOOOOOOOOOOOOOOOOOOOOOOOOOOOOX
XOOOOOOOOOOOOOOOOOOOOOOOOOOOOX
XOOOOOOOOOOOOOOOOOOOOOOOOOOOOX
XOOOOOOOOOOOOOOOOOOOOOOOOOOOOX
XOOOOOOOOOOOOOOOOOOOOOOOOOOOOX
XOOOOOOOOOOOOOOOOOOOOOOOOOOOOX
XOOOOOOOOOOOOOOOOOOOOOOOOOOOOX
XOOOOOOOOOOOOOOOOOOOOOOOOOOOOX
XOOOOOOOOOOOOOOOOOOOOOOOOOOOOX
XOOOOOOOOOOOOOOOOOOOOOOOOOOOOX
XOOOOOOOOOOOOOOOOOOOOOOOOOOOOX
XOOOOOOOOOOOOOOOOOOOOOOOOOOOOX
XOOOOOOOOOOOOOOOOOOOOOOOOOOOOX
XOOOOOOOOOOOOOOOOOOOOOOOOOOOOX
XOOOOOOOOOOOOOOOOOOOOOOOOOOOOX
XXXXXXXXXXXXXXXXXXXXXXXXXXXXXX
XXXXXXXXXXXXXXXXXXXXXXXXXXXXXX
XOOOOOOOOOOOOOOOOOOOOOOOOOOOOX
XOOOOOOOOOOOOOOOOOOOOOOOOOOOOX
XOOOOOOOOOOOOOOOOOOOOOOOOOOOOX
XOOOOOOOOOOOOOOOOOOOOOOOOOOOOX
XOOOOOOOOOOOOOOOOOOOOOOOOOOOOX
XOOOOOOOOOOOOOOOOOOOOOOOOOOOOX
XOOOOOOOOOOOOOOOOOOOOOOOOOOOOX
XOOOOOOOOOOOOOOOOOOOOOOOOOOOOX
XOOOOOOOOOOOOOOOOOOOOOOOOOOOOX
XOOOOOOOOOOOOOOOOOOOOOOOOOOOOX
XOOOOOOOOOOOOOOOOOOOOOOOOOOOOX
XOOOOOOOOOOOOOOOOOOOOOOOOOOOOX
XOOOOOOOOOOOOOOOOOOOOOOOOOOOOX
XOOOOOOOOOOOOOOOOOOOOOOOOOOOOX
XOOOOOOOOOOOOOOOOOOOOOOOOOOOOX
XOOOOOOOOOOOOOOOOOOOOOOOOOOOOX
XOOOOOOOOOOOOOOOOOOOOOOOOOOOOX
XOOOOOOOOOOOOOOOOOOOOOOOOOOOOX
XOOOOOOOOOOOOOOOOOOOOOOOOOOOOX
XOOOOOOOOOOOOOOOOOOOOOOOOOOOOX
XOOOOOOOOOOOOOOOOOOOOOOOOOOOOX
XOOOOOOOOOOOOOOOOOOOOOOOOOOOOX
XOOOOOOOOOOOOOOOOOOOOOOOOOOOOX
XOOOOOOOOOOOOOOOOOOOOOOOOOOOOX
XOOOOOOOOOOOOOOOOOOOOOOOOOOOOX
XOOOOOOOOOOOOOOOOOOOOOOOOOOOOX
XOOOOOOOOOOOOOOOOOOOOOOOOOOOOX
XOOOOOOOOOOOOOOOOOOOOOOOOOOOOX
XXXXXXXXXXXXXXXXXXXXXXXXXXXXXX
XXXXXXXXXXXXXXXXXXXXXXXXXXXXXX
XOOOOOOOOOOOOOOOOOOOOOOOOOOOOX
XOOOOOOOOOOOOOOOOOOOOOOOOOOOOX
XOOOOOOOOOOOOOOOOOOOOOOOOOOOOX
XOOOOOOOOOOOOOOOOOOOOOOOOOOOOX
XOOOOOOOOOOOOOOOOOOOOOOOOOOOOX
XOOOOOOOOOOOOOOOOOOOOOOOOOOOOX
XOOOOOOOOOOOOOOOOOOOOOOOOOOOOX
XOOOOOOOOOOOOOOOOOOOOOOOOOOOOX
XOOOOOOOOOOOOOOOOOOOOOOOOOOOOX
XOOOOOOOOOOOOOOOOOOOOOOOOOOOOX
XOOOOOOOOOOOOOOOOOOOOOOOOOOOOX
XOOOOOOOOOOOOOOOOOOOOOOOOOOOOX
XOOOOOOOOOOOOOOOOOOOOOOOOOOOOX
XOOOOOOOOOOOOOOOOOOOOOOOOOOOOX
XOOOOOOOOOOOOOOOOOOOOOOOOOOOOX
XOOOOOOOOOOOOOOOOOOOOOOOOOOOOX
XOOOOOOOOOOOOOOOOOOOOOOOOOOOOX
XOOOOOOOOOOOOOOOOOOOOOOOOOOOOX
XOOOOOOOOOOOOOOOOOOOOOOOOOOOOX
XOOOOOOOOOOOOOOOOOOOOOOOOOOOOX
XOOOOOOOOOOOOOOOOOOOOOOOOOOOOX
XOOOOOOOOOOOOOOOOOOOOOOOOOOOOX
XOOOOOOOOOOOOOOOOOOOOOOOOOOOOX
XOOOOOOOOOOOOOOOOOOOOOOOOOOOOX
XOOOOOOOOOOOOOOOOOOOOOOOOOOOOX
XOOOOOOOOOOOOOOOOOOOOOOOOOOOOX
XOOOOOOOOOOOOOOOOOOOOOOOOOOOOX
XOOOOOOOOOOOOOOOOOOOOOOOOOOOOX
XXXXXXXXXXXXXXXXXXXXXXXXXXXXXX
